Name	Description
Animals	All about Animals
Brain-Teasers	Best Brain Teasers
Celebrities	All about Celebrities
Entertainment	Entertainment Trivia
For-Kids	For Kids - Fun!
General	General Knowledge
Geography	Geographical Trivia
History	All about Historical Facts
Hobbies	Hmm.. Hobbies
Humanities	Remember your Humanities study
Literature	All about Literature
Movies	All about Movies
Music	All about Music
Newest	"All Newest, Assorted!"
People	All about Pouplar and Famed people
Rated	Rated - WTH?
Religion-Faith	All about Worldly Relistions and Faiths
Science-Technology	"Here comes Science and Technology, you may like it :)"
Sports	All about Sports
Television	All about Television
Video-Games	Yay!! Video Games
World	World Facts